111111111111111111111111111
1P0000000000000000000000001
1000000001F1000001111111101
1000000CCCF00000CCC0000CC01
10000CFC0CC000000000FCCC001
100CFC00CCC0000000F1C000001
1C1F1C1C1C1C000CFC000000001
1000001C100001C100000F00001
1000011100011111111ECC00001
100000000000000000000000001
111111111111111111111111111