111111111111111111111111111
1P0000000000000000000000001
100000000111000000111111111
1000000CCC000000CCC0000CCC1
10000CCC0CCC000000000CCC001
100C1C00CCC0000000C1C000001
1C1C1C1C1C1C000C1C000000001
1000001C100001C100000000001
1000011100011111111ECC00001
100000000000000000000000001
111111111111111111111111111