1111111111111111111
1P00000000000000001
1111111111111111111
10000C00C000000E001
1111111111111111111