111111111111111111111111
1000010000000001000E0001
100C0100PC00000100000001
100F010000000F0000000001
110111100001111100111011
110111111011111111111011
100000C00000000000C00001
111111111111111111111111