111111111111111111111111
10000000P000000000000001
1000000000C000000000E001
111111111111111111111111