11111111111111111111
1P00000C000C0000E0C1
11111111111111111111