11111111111111111111111
100P000000000000000E001
10000000000000000111111
100C00000000000C0000001
10000000000000000001101
100C00000000000C0001C01
11111111111111111111111