11111111111111111111111
10000000P00000000000000
1000000000C0000000E00001Y
1000000000000000000000011E
111111111111111111111111111