1111111111111111111111111
100000000000P000000000001
100000000000000C000000000
1000000000000000000000E00
1111111111111111111111111