111111111
100C0P0E1
000000000
100000001
111111101
100000001
100000001
100000001
111111111