111111111111111111111111
1000000000000001000E0001
10000000PC00000100000001
100000000000000000000001
110111111111111111111011
110111111111111111111011
100000C00000000000000001
111111111111111111111111