111111111111111111111111
100000000000000000000011
10000000P0C000000000E011
111111111111111111111111