1111111111111111111111111
100000000000P000000000001
1000000000000000C00000000
1000000000000000000000E00
1111111111111111111111111