11111111111111111
10P00000000000000
10000C00000000000
10000000000000000
10000C0000000E000
11111111111111111